Queens South,2005,2006,2007,2008,2009,Total
100th Precinct,21,16,27,17,22,103
101st Precinct,45,45,63,42,24,219
102nd Precinct,32,27,26,22,13,120
103rd Precinct,76,84,77,64,45,346
105th Precinct,41,58,42,18,33,192
106th Precinct,28,24,26,34,31,143
107th Precinct,27,26,25,20,24,122
113th Precinct,33,47,33,38,44,195
Precincts Total,303,327,319,255,236,1440
Task Force,13,11,8,3,9,44
Borough HQ,4,1,0,2,1,8
Anti-crime Unit,4,2,4,4,3,17
Patrol Borough Queens South Total,324,341,331,264,249,1509
