Staten Island,2005,2006,2007,2008,2009,Total
120th Precinct,43,68,74,50,61,296
122nd Precinct,29,37,27,25,26,144
123rd Precinct,11,17,11,10,11,60
Precincts Total,83,122,112,85,98,500
Task Force,9,6,3,1,5,24
Borough HQ,1,0,0,1,4,6
Anti-Crime Unit,2,6,1,2,1,12
Housing,5,2,0,0,0,7
Court,0,0,2,1,2,5
Patrol Borough Staten Island Total,100,136,118,90,110,554
